RepairMyCar
An Interactive Fiction by Jaryd Ma
Release 1 / Serial number 141022 / Inform 7 build 6L38 (I6/v6.33 lib 6/12N) SD

Car Wreckage
Your car is a total wreck, you need to fix it ASAP.

Bathrooms are north. The roadside is West. The cigarette vending machine is East. The dead end is South.

I beg your pardon?

* * *

RepairMyCar
An Interactive Fiction by Jaryd Ma
Release 1 / Serial number 141022 / Inform 7 build 6L38 (I6/v6.33 lib 6/12N) SD

Car Wreckage
Your car is a total wreck, you need to fix it ASAP.

Bathrooms are north. The roadside is West. The cigarette vending machine is East. The dead end is South.

>w
Roadside
The roadside is deserted except for some trash on the side of the curb. There is a old street light next to you.

The car wreckage is East.

>x lgiht
You can't see any such thing.

>x light
rusty and silver. There is nothing special about it.

>x trash
You see a smashed soda can, a gum wrapper and a copper coin.

>take coin
(the bronze coin)
You already have that.

>take copper coin
Taken.

>i
You are carrying:
  Copper coin
  a bronze coin

>e
Car Wreckage
_____________ Bathrooms are north. The roadside is West. The cigarette vending machine is East. The dead end is South.

>e
Cigarette Vending Machine
__________________ The car wreckage is West. The car repair shop is East.

You can see the cigarette machine here.

>give bronze coin
(to the cigarette machine)
The machine rattles and drops a tail light with a large thud. You reach in and grab it.

>give copper coin
(to the cigarette machine)
The machine rattles and drops a tire with a large thud. You reach in and grab it.

>i
You are carrying:
  a tire
  a bumper

* * *

>w
Roadside
The roadside is deserted except for some trash on the side of the curb. There is a old street light next to you.

The car wreckage is East.

>w
You can't go that way.

>x trash
You see a smashed soda can, a gum wrapper and a copper coin.

* * *

>take copper coin
Taken.

>take silver coin
Taken.

>e
Car Wreckage
_____________ Bathrooms are north. The roadside is West. The cigarette vending machine is East. The dead end is South.

* * *

>e
Cigarette Vending Machine
__________________ The car wreckage is West. The car repair shop is East.

You can see the cigarette machine here.

>buy bumper
The machine rattles and drops a tire with a large thud. You reach in and grab it.

>buy tire
You don't have enough money.

>buy tire with coin
I only understood you as far as wanting to buy the tire.

* * *

>w
Roadside
The roadside is deserted except for some trash on the side of the curb. There is a old street light next to you.

The car wreckage is East.

>e
Car Wreckage
_____________ Bathrooms are north. The roadside is West. The cigarette vending machine is East. The dead end is South.

* * *

>e
Cigarette Vending Machine
__________________ The car wreckage is West. The car repair shop is East.

You can see the cigarette machine here.

>w
Car Wreckage
_____________ Bathrooms are north. The roadside is West. The cigarette vending machine is East. The dead end is South.

>w
Roadside
The roadside is deserted except for some trash on the side of the curb. There is a old street light next to you. The car wreckage is East.

>take all
(the bronze coin)
You already have that.

>x trash
You see a smashed soda can, a gum wrapper and a copper coin.

* * *

>e
Cigarette Vending Machine
__________________ The car wreckage is West. The car repair shop is East.

You can see the cigarette machine here.

>buy tire
The machine rattles and drops a tire with a large thud. You reach in and grab it.

>buy tail light with bronze coin
I only understood you as far as wanting to buy the tail light.

>buy tail light
You don't have enough money.

>i
You are carrying:
  a tire
  a bronze coin

>give bronze coin
(to the cigarette machine)
The machine rattles and drops a tail light with a large thud. You reach in and grab it.

* * *

>take copper
Taken.

>w
You can't go that way.

>e
Car Wreckage
Your car is a total wreck, you need to fix it ASAP.

Bathrooms are north. The roadside is West. The cigarette vending machine is East. The dead end is South.

* * *

>buy engine
You don't have enough money.

>i
You are carrying:
  Copper coin
  a bronze coin

* * *

>x trash
You see a smashed soda can, a gum wrapper and a copper coin.

>e
Car Wreckage
_____________ Bathrooms are north. The roadside is West. The cigarette vending machine is East. The dead end is South.

* * *

>e
Cigarette Vending Machine
__________________ The car wreckage is West. The car repair shop is East.

You can see the cigarette machine here.

>x machine
An old vending machine filled with many car parts. There is a sign on the machine.

Engine - mysterious coin

Bumper - silver coin

Tail light - bronze coin

Tire - copper coin

>buy light
You don't have enough money.

>buy tire
You don't have enough money.

* * *

>x trash
You see a smashed soda can, a gum wrapper and a copper coin.

>take all
(the bronze coin)
You already have that.

>take coin
(the bronze coin)
You already have that.

* * *

>e
Cigarette Vending Machine
__________________ The car wreckage is West. The car repair shop is East.

You can see the cigarette machine here.

>x it
A rusty copper coin. You can't see anything unusual about it.

>x machine
An old vending machine filled with many car parts. There is a sign on the machine.

Engine - mysterious coin

Bumper - silver coin

Tail light - bronze coin

Tire - copper coin

* * *

>buy tire
The machine rattles and drops a tire with a large thud. You reach in and grab it.

>buy bumper
You don't have enough money.

* * *

>buy bumper
The machine rattles and drops a tire with a large thud. You reach in and grab it.

>x machine
An old vending machine filled with many car parts. There is a sign on the machine.

Engine - mysterious coin

Bumper - silver coin

Tail light - bronze coin

Tire - copper coin

* * *

>buy tire
You don't have enough money.

>i
You are carrying:
  a tire
  silver coin
  a bronze coin

* * *

RepairMyCar
An Interactive Fiction by Jaryd Ma
Release 1 / Serial number 141022 / Inform 7 build 6L38 (I6/v6.33 lib 6/12N) SD

Car Wreckage
Your car is a total wreck, you need to fix it ASAP.

Bathrooms are north. The roadside is West. The cigarette vending machine is East. The dead end is South.

>put coin to machine
The machine rattles and drops an object down with a large thud.

* * *

RepairMyCar
An Interactive Fiction by Jaryd Ma
Release 1 / Serial number 141022 / Inform 7 build 6L38 (I6/v6.33 lib 6/12N) SD

Car Wreckage
Your car is a total wreck, you need to fix it ASAP.

Bathrooms are north. The roadside is West. The cigarette vending machine is East. The dead end is South.

>place coin in machine
That's not a verb I recognise.

* * *

RepairMyCar
An Interactive Fiction by Jaryd Ma
Release 1 / Serial number 141022 / Inform 7 build 6L38 (I6/v6.33 lib 6/12N) SD

Car Wreckage
Your car is a total wreck, you need to fix it ASAP.

Bathrooms are north. The roadside is West. The cigarette vending machine is East. The dead end is South.

>hi
That's not a verb I recognise.

* * *

RepairMyCar
An Interactive Fiction by Jaryd Ma
Release 1 / Serial number 141022 / Inform 7 build 6L38 (I6/v6.33 lib 6/12N) SD

Car Wreckage
Your car is a total wreck, you need to fix it ASAP.

Bathrooms are north. The roadside is West. The cigarette vending machine is East. The dead end is South.

>put coin in machine
You can only do that to something animate.

I beg your pardon?

* * *

>put coin in machine
You can only do that to something animate.

>give coin to machine
The machine rattles and drops an object down with a large thud.

* * *

>put coin in machine
You can only do that to something animate.

>put coin in the cigarette machine
That's not a verb I recognise.

* * *

>put coin in machine
You can only do that to something animate.

>put coin to machine
The machine rattles and drops an object down with a large thud.

* * *

RepairMyCar
An Interactive Fiction by Jaryd Ma
Release 1 / Serial number 141022 / Inform 7 build 6L38 (I6/v6.33 lib 6/12N) SD

Car Wreckage
Your car is a total wreck, you need to fix it ASAP.

Bathrooms are north. The roadside is West. The cigarette vending machine is East. The dead end is South.

>give machine coin
The machine rattles and drops an object down with a large thud.

* * *

RepairMyCar
An Interactive Fiction by Jaryd Ma
Release 1 / Serial number 141022 / Inform 7 build 6L38 (I6/v6.33 lib 6/12N) SD

Car Wreckage
Your car is a total wreck, you need to fix it ASAP.

Bathrooms are north. The roadside is West. The cigarette vending machine is East. The dead end is South.

>use coin on machine
That's not a verb I recognise.

>put coin in machine
He can't contain things.

>give coin to machine
The machine rattles and drops an object down with a large thud.

* * *

RepairMyCar
An Interactive Fiction by Jaryd Ma
Release 1 / Serial number 141022 / Inform 7 build 6L38 (I6/v6.33 lib 6/12N) SD

Car Wreckage
Your car is a total wreck, you need to fix it ASAP.

Bathrooms are north. The roadside is West. The cigarette vending machine is East. The dead end is South.

>buy engine
The machine rattles and drops an object down with a large thud.

* * *

RepairMyCar
An Interactive Fiction by Jaryd Ma
Release 1 / Serial number 141022 / Inform 7 build 6L38 (I6/v6.33 lib 6/12N) SD

Car Wreckage
Your car is a total wreck, you need to fix it ASAP.

Bathrooms are north. The roadside is West. The cigarette vending machine is East. The dead end is South.

>give coin to cigarette machine
The machine rattles and drops an object down with a large thud.

>i
You are carrying:
  an engine

>give cigarette machine coin
(first taking the copper coin)
That seems to belong to cigarette machine.

* * *

RepairMyCar
An Interactive Fiction by Jaryd Ma
Release 1 / Serial number 141022 / Inform 7 build 6L38 (I6/v6.33 lib 6/12N) SD

Car Wreckage
Your car is a total wreck, you need to fix it ASAP.

Bathrooms are north. The roadside is West. The cigarette vending machine is East. The dead end is South.

>x car
Your 18th birthday present is now needing a new a tire, tail light, engine and bumper.

>w
Roadside
The roadside is deserted except for some trash on the side of the curb. There is a old street light next to you. The car wreckage is East.

>x trash
You see a smashed soda can, a gum wrapper and a copper coin.

* * *

>take copper coin
Taken.

>e
Car Wreckage
Your car is a total wreck, you need to fix it ASAP. Bathrooms are north. The roadside is West. The cigarette vending machine is East. The dead end is South.

>n
Bathrooms
_______________ Car wreckage is South. The Convenience Store is North.

>n
Convenience Store
 An air conditioned store with bright lights. There is a cashier at the front. Bathrooms are South.

You can see Cashier here.

>talk to cashier
That's not a verb I recognise.

>ask cashier about water
Sure, we got some. Since you are the 100th costumer today, I will give it to you for free! Congratulations!

>take water
You already have that.

>hi
That's not a verb I recognise.

>s
Bathrooms
_______________ Car wreckage is South. The Convenience Store is North.

>s
Car Wreckage
Your car is a total wreck, you need to fix it ASAP. Bathrooms are north. The roadside is West. The cigarette vending machine is East. The dead end is South.

>i
You are carrying:
  Water bottle
  Copper coin
  a bronze coin

>s
Dead End
There is a hurt runner stretching on the curb. He looks like he needs help. The car wreckage is North. The forest is South.

You can see Hurt Runner here.

>give runner water
You hand the water bottle to the hurt runner and he immidiatly drinks it.

"Thanks for the water man, my cramping is finally going away. Here is a mysterious coin, you deserve it!

>i
You are carrying:
  a mysterious coin
  Copper coin
  a bronze coin

>n
Car Wreckage
Your car is a total wreck, you need to fix it ASAP. Bathrooms are north. The roadside is West. The cigarette vending machine is East. The dead end is South.

>e
Cigarette Vending Machine
__________________ The car wreckage is West. The car repair shop is East.

You can see the cigarette machine here.

>e
Car Repair Shop
________________________ The cigarette vending machine is West.

>w
Cigarette Vending Machine
__________________ The car wreckage is West. The car repair shop is East.

You can see the cigarette machine here.

>buy tire
The machine rattles and drops a tire with a large thud. You reach in and grab it.

>give machine copper coin
You can't see any such thing.

>i
You are carrying:
  a tire
  a mysterious coin
  a bronze coin

>give machine bronze coin
The machine rattles and drops a tail light with a large thud. You reach in and grab it.

>give machine mysterious coin
The machine rattles and drops an engine with a large thud. You reach in and grab it.

>i
You are carrying:
  an engine
  a bumper
  a tire

* * *

RepairMyCar
An Interactive Fiction by Jaryd Ma
Release 1 / Serial number 141022 / Inform 7 build 6L38 (I6/v6.33 lib 6/12N) SD

Car Wreckage
Your car is a total wreck, you need to fix it ASAP.

Bathrooms are north. The roadside is West. The cigarette vending machine is East. The dead end is South.

>go north
You can't go that way.

* * *

RepairMyCar
An Interactive Fiction by Jaryd Ma
Release 1 / Serial number 141022 / Inform 7 build 6L38 (I6/v6.33 lib 6/12N) SD

Car Wreckage
Your car is a total wreck, you need to fix it ASAP.

Bathrooms are north. The roadside is West. The cigarette vending machine is East. The dead end is South.

>e
Cigarette Vending Machine
An empty area except for an odd looking vending machine. The car wreckage is West. The car repair shop is East.

You can see the cigarette machine here.

>buy tire
(to the cigarette machine)
(first taking the tire)
That seems to belong to the cigarette machine.

>buy copper coin
(to the cigarette machine)
The machine rattles and drops a tire with a large thud. You reach in and grab it.

* * *

RepairMyCar
An Interactive Fiction by Jaryd Ma
Release 1 / Serial number 141022 / Inform 7 build 6L38 (I6/v6.33 lib 6/12N) SD

Car Wreckage
Your car is a total wreck, you need to fix it ASAP.

Bathrooms are north. The roadside is West. The cigarette vending machine is East. The dead end is South.

>x cigarette machine
An old vending machine filled with many car parts. There is a sign on the machine.

1 Engine - gold coin

1 Bumper - silver coin

1 Tail light - bronze coin

1 Tire - copper coin

* * *

RepairMyCar
An Interactive Fiction by Jaryd Ma
Release 1 / Serial number 141022 / Inform 7 build 6L38 (I6/v6.33 lib 6/12N) SD

Car Wreckage
Your car is a total wreck, you need to fix it ASAP.

Bathrooms are north. The roadside is West. The cigarette vending machine is East. The dead end is South.

>n
Bathrooms
A ordinary public bathroom. There is graffiti on the walls, an overflowing rubbish can, and no toilet paper.

Car wreckage is South. The Convenience Store is North.

* * *

>x toilet
Something is clogging the toilet, you look closer and see something shiney. You reluctantly reach in and grab it.

It's a silver coin!

>i
You are carrying:
  a silver coin
  a bronze coin

* * *

>s
Dead End
There is a hurt runner stretching on the curb. He looks like he needs help.

The car wreckage is North. The forest is South.

You can see Hurt Runner here.

>s
Forest
What lies beyond here is a mystery. All you see is tall trees. The dead end is North.

>n
Dead End
There is a hurt runner stretching on the curb. He looks like he needs help.

The car wreckage is North. The forest is South.

You can see Hurt Runner here.

>n
Car Wreckage
Your car is a total wreck, you need to fix it ASAP.

Bathrooms are north. The roadside is West. The cigarette vending machine is East. The dead end is South.

* * *

RepairMyCar
An Interactive Fiction by Jaryd Ma
Release 1 / Serial number 141022 / Inform 7 build 6L38 (I6/v6.33 lib 6/12N) SD

Car Wreckage
Your car is a total wreck, you need to fix it ASAP.

Bathrooms are north. The roadside is West. The cigarette vending machine is East. The dead end is South.

>x vending machine
You can't see any such thing.

>x cigarette machine
An old vending machine filled with many car parts. There is a sign on the machine.

1 Engine - gold coin 1 Bumper - silver coin 1 Tail light - bronze coin 1 Tire - copper coin

* * *

RepairMyCar
An Interactive Fiction by Jaryd Ma
Release 1 / Serial number 141022 / Inform 7 build 6L38 (I6/v6.33 lib 6/12N) SD

Car Wreckage
Your car is a total wreck, you need to fix it ASAP.

Bathrooms are north. The roadside is West. The cigarette vending machine is East. The dead end is South.

>give coin to Instead of buying the engine:
You can't see any such thing.

>if the player has the coin, try giving the coin to the cigarette machine;
You seem to want to talk to someone, but I can't see whom.