RepairMyCar
An Interactive Fiction by Jaryd Ma
Release 1 / Serial number 141014 / Inform 7 build 6L38 (I6/v6.33 lib 6/12N) SD

Cigarette Vending Machine
You can see cigarette machine here.

>put coin in machine
You can only do that to something animate.

* * *

RepairMyCar
An Interactive Fiction by Jaryd Ma
Release 1 / Serial number 141014 / Inform 7 build 6L38 (I6/v6.33 lib 6/12N) SD

Cigarette Vending Machine
You can see cigarette machine here.

>put coin to machine
The machine rattles and drops an object down with a large thud.

* * *

RepairMyCar
An Interactive Fiction by Jaryd Ma
Release 1 / Serial number 141014 / Inform 7 build 6L38 (I6/v6.33 lib 6/12N) SD

Cigarette Vending Machine
You can see cigarette machine here.

>give cigarette machine coin
Which do you mean, the copper coin or the blue coin?

* * *

RepairMyCar
An Interactive Fiction by Jaryd Ma
Release 1 / Serial number 141014 / Inform 7 build 6L38 (I6/v6.33 lib 6/12N) SD

Cigarette Vending Machine
You can see cigarette machine here.

>x
(the copper coin)
You see nothing special about the copper coin.

>x cigarette machine
An old vending machine filled with many car parts including ENGINES, TIRES, TAIL LIGHTS, and BUMPERS.

* * *

RepairMyCar
An Interactive Fiction by Jaryd Ma
Release 1 / Serial number 141014 / Inform 7 build 6L38 (I6/v6.33 lib 6/12N) SD

Cigarette Vending Machine
You can see cigarette machine here.

>i
You are carrying:
  a copper coin

>open money in the dank
You can't see any such thing.

>put copper coin in machine
He can't contain things.

>give copper coin to machine
The machine rattles and drops an object down with a large thud.

* * *

>i
You are carrying:
  a copper coin

>give The player carries a copper coin. The cigarette machine carries an engine.
You can't see any such thing.

>Instead of giving the coin to the cigarette machine:
That's not a verb I recognise.

>now the cigarette machine carries the coin;
That's not a verb I recognise.

>now the player carries the engine;
That's not a verb I recognise.

>say "The machine rattles and drops an object down with a large thud."
(to cigarette machine)
There is no reply.

* * *

RepairMyCar
An Interactive Fiction by Jaryd Ma
Release 1 / Serial number 141014 / Inform 7 build 6L38 (I6/v6.33 lib 6/12N) SD

Cigarette Vending Machine
You can see cigarette machine here.

>give cigarette machine copper coin
The machine rattles and drops an object down with a large thud.

>give cigarette machine blue coin
The machine rattles and drops an object down with a large thud.

>i
You are carrying:
  a bumper
  an engine

* * *

RepairMyCar
An Interactive Fiction by Jaryd Ma
Release 1 / Serial number 141014 / Inform 7 build 6L38 (I6/v6.33 lib 6/12N) SD

Cigarette Vending Machine
You can see cigarette machine here.

>give machine coin
The machine rattles and drops an object down with a large thud.

* * *

RepairMyCar
An Interactive Fiction by Jaryd Ma
Release 1 / Serial number 141014 / Inform 7 build 6L38 (I6/v6.33 lib 6/12N) SD

Cigarette Vending Machine
You can see cigarette machine here.

>talk to  cigarette machine
That's not a verb I recognise.

>ask  cigarette machine about coin
There is no reply.

>x coin
You see nothing special about the copper coin.

>give  cigarette machine copper coin
The machine rattles and drops an object down with a large thud.

>i
You are carrying:
  an engine

>x  cigarette machine
You see nothing special about cigarette machine.

* * *

RepairMyCar
An Interactive Fiction by Jaryd Ma
Release 1 / Serial number 141014 / Inform 7 build 6L38 (I6/v6.33 lib 6/12N) SD

Cigarette Vending Machine
You can see cigarette machine here.

>use coin on machine
That's not a verb I recognise.

* * *

RepairMyCar
An Interactive Fiction by Jaryd Ma
Release 1 / Serial number 141014 / Inform 7 build 6L38 (I6/v6.33 lib 6/12N) SD

Cigarette Vending Machine
You can see cigarette machine here.

>buy engine
The machine rattles and drops an object down with a large thud.

* * *

RepairMyCar
An Interactive Fiction by Jaryd Ma
Release 1 / Serial number 141014 / Inform 7 build 6L38 (I6/v6.33 lib 6/12N) SD

Cigarette Vending Machine
You can see cigarette machine here.

>give coin to cigarette machine
The machine rattles and drops an object down with a large thud.

* * *

RepairMyCar
An Interactive Fiction by Jaryd Ma
Release 1 / Serial number 141014 / Inform 7 build 6L38 (I6/v6.33 lib 6/12N) SD

Cigarette Vending Machine
You can see cigarette machine here.

>go north
You can't go that way.

* * *

RepairMyCar
An Interactive Fiction by Jaryd Ma
Release 1 / Serial number 141014 / Inform 7 build 6L38 (I6/v6.33 lib 6/12N) SD

Cigarette Vending Machine
You can see cigarette machine here.

>x  cigarette machine
An old vending machine filled with many car parts including ENGINES, TIRES, TAIL LIGHTS, and BUMPERS.

* * *

RepairMyCar
An Interactive Fiction by Jaryd Ma
Release 1 / Serial number 141014 / Inform 7 build 6L38 (I6/v6.33 lib 6/12N) SD

Cigarette Vending Machine
You can see cigarette machine here.

>buy cake
You can't see any such thing.

>x ogre
You can't see any such thing.

>i
You are carrying:
  a copper coin

>give coin to ogre
You can't see any such thing.

* * *

RepairMyCar
An Interactive Fiction by Jaryd Ma
Release 1 / Serial number 141014 / Inform 7 build 6L38 (I6/v6.33 lib 6/12N) SD

Cigarette Vending Machine
You can see cigarette machine here.

>x cigarette machine
An old vending machine filled with many car parts. There is a sign on the machine.

1 Engine - gold coin

1 Bumper - silver coin

1 Tail light - bronze coin

1 Tire - copper coin

* * *

RepairMyCar
An Interactive Fiction by Jaryd Ma
Release 1 / Serial number 141014 / Inform 7 build 6L38 (I6/v6.33 lib 6/12N) SD

Cigarette Vending Machine
You can see cigarette machine here.

>x vending machine
You can't see any such thing.

* * *

RepairMyCar
An Interactive Fiction by Jaryd Ma
Release 1 / Serial number 141014 / Inform 7 build 6L38 (I6/v6.33 lib 6/12N) SD

Cigarette Vending Machine
You can see cigarette machine here.

>place coin in machine
That's not a verb I recognise.

* * *

RepairMyCar
An Interactive Fiction by Jaryd Ma
Release 1 / Serial number 141014 / Inform 7 build 6L38 (I6/v6.33 lib 6/12N) SD

Cigarette Vending Machine
You can see cigarette machine here.

>give coin to Instead of buying the engine:
You can't see any such thing.

* * *

>if the player has the coin, try giving the coin to the cigarette machine;
You seem to want to talk to someone, but I can't see whom.

>otherwise say "You have not enough money."
That's not a verb I recognise.