Driving home one night, you fall asleep on the highway. You wake up with a bloody nose and you wonder what just happened. You climb out of your car and see that it is totally wrecked. Luckily, no one was hurt in the crash. You realize that you have to find a repair shop fast because you don't want your parents to know where you are. You reach into the glove compartment for money and all you find is a bronze coin.

RepairMyCar
A Car Fixing Tale by Jaryd Ma
Release 1 / Serial number 141028 / Inform 7 build 6L38 (I6/v6.33 lib 6/12N) SD

Car Wreckage
Your car is a total wreck, you need to fix it ASAP.

Bathrooms are north. The roadside is West. The cigarette vending machine is East. The dead end is South.

I beg your pardon?

I beg your pardon?

* * *

>take all
No cheating

>n
Bathrooms
A ordinary public bathroom. There is graffiti on the walls, an overflowing rubbish can, and no toilet paper.

Car wreckage is South. The Convenience Store is North.

>x trash can
You can't see any such thing.

>x rubbish can
An overflowing trash can, nothing special.

>x graffiti
I droPPeD soMEThinG iN THE toiLeT :)

>x toilet
Something is clogging the toilet, you look closer and see something shiney. You reluctantly reach in and grab it.

It's a silver coin!

>eat coin
Which do you mean, silver coin or the bronze coin?

>bronze coin
That's plainly inedible.

>s
Car Wreckage
Your car is a total wreck, you need to fix it ASAP.

Bathrooms are north. The roadside is West. The cigarette vending machine is East. The dead end is South.

>w
Roadside
The roadside is deserted except for some trash on the side of the curb. There is a old street light next to you.

The car wreckage is East.

>x trash
You see a smashed soda can, a gum wrapper and a copper coin.

>take copper coin
Taken.

>take gum wrapper
Taken.

>take soda can
Taken.

>e
Car Wreckage
Your car is a total wreck, you need to fix it ASAP.

Bathrooms are north. The roadside is West. The cigarette vending machine is East. The dead end is South.

>e
Cigarette Vending Machine
An empty area except for an odd looking vending machine. The car wreckage is West. The car repair shop is East.

You can see the cigarette machine here.

>w
Car Wreckage
Your car is a total wreck, you need to fix it ASAP.

Bathrooms are north. The roadside is West. The cigarette vending machine is East. The dead end is South.

>s
Dead End
There is a hurt runner stretching on the curb. He looks like he needs help.

The car wreckage is North. The forest is South.

You can see Hurt Runner here.

>take runner
I don't suppose Hurt Runner would care for that.

>x runner
He looks tired and sweaty, it seems like his leg is cramping up.

>chop runner's leg off with soda can
You can't see any such thing.

>talk to runner
That's not a verb I recognise.

>ask runner
What do you want to ask Hurt Runner for?

* * *

>hi
That's not a verb I recognise.

>Silver Coin
That's not a verb I recognise.

>bumper
That's not a verb I recognise.

>What's in the machine?
That's not a verb I recognise.

>examine machine
An old vending machine filled with many car parts. There is a sign on the machine.

Engine - mysterious coin

Bumper - silver coin

Tail light - bronze coin

Tire - copper coin

>Engine
That's not a verb I recognise.

>i
You are carrying:
  a bronze coin

>Bronze coin
That's not a verb I recognise.

>a bronze coin
That's not a verb I recognise.

>tail light
That's not a verb I recognise.

>give you bronze coin
You can't see any such thing.

>plug in bronze coin
That's not a verb I recognise.

>give coin to machine
The machine rattles and drops a tail light with a large thud. You reach in and grab it.

* * *

>i
You are carrying:
  Bronze coin

>w
Roadside
The roadside is deserted except for some trash on the side of the curb. There is a old street light next to you.

The car wreckage is East.

>e
Car Wreckage
Your car is a total wreck, you need to fix it ASAP.

Bathrooms are north. The roadside is West. The cigarette vending machine is East. The dead end is South.

>n
Bathrooms
A ordinary public bathroom. There is graffiti on the walls, an overflowing rubbish can, and no toilet paper.

Car wreckage is South. The Convenience Store is North.

>n
Convenience Store
 An air conditioned store with bright lights. There is a cashier at the front. Bathrooms are South.

You can see Cashier here.

>s
Bathrooms
A ordinary public bathroom. There is graffiti on the walls, an overflowing rubbish can, and no toilet paper.

Car wreckage is South. The Convenience Store is North.

>s
Car Wreckage
Your car is a total wreck, you need to fix it ASAP.

Bathrooms are north. The roadside is West. The cigarette vending machine is East. The dead end is South.

>s
Dead End
There is a hurt runner stretching on the curb. It looks like his leg is cramping. He may need your help.

The car wreckage is North. The forest is South.

You can see Hurt Runner here.

>n
Car Wreckage
Your car is a total wreck, you need to fix it ASAP.

Bathrooms are north. The roadside is West. The cigarette vending machine is East. The dead end is South.

>e
Cigarette Vending Machine
An empty area except for an odd looking vending machine. The car wreckage is West. The car repair shop is East.

You can see the cigarette machine here.

>x machine
An old vending machine filled with many car parts. There is a sign on the machine.

Engine - mysterious coin

Bumper - silver coin

Tail light - bronze coin

Tire - copper coin

>e
Car Repair Shop
A poor lit garage gives you the impression that buisness is slow. The walls are baren and there there is nothing much here. You wonder if this is even the right place. There is a man named Jack sitting down behind a desk.

The cigarette vending machine is West.

You can see Jack here.

* * *

>i
You are carrying:
  Bronze coin

>e
Cigarette Vending Machine
An empty area except for an odd looking vending machine. The car wreckage is West. The car repair shop is East.

You can see the cigarette machine here.

>e
Car Repair Shop
A poorly lit garage gives you the impression that business is slow. The walls are barren and there is nothing much here. You wonder if this is even the right place. There is a man named Jack sitting down behind a desk.

The cigarette vending machine is West.

You can see Jack here.

>give bronze coin to jack
Not me, the vending machine man! Do I look like a vending machine to you?

* * *

>x machine
An old vending machine filled with many car parts. There is a sign on the machine.

Engine - mysterious coin

Bumper - silver coin

Tail light - bronze coin

Tire - copper coin

>buy tail light
The machine rattles and drops a tail light with a large thud. You reach in and grab it.

>i
You are carrying:
  a tail light

>l
Cigarette Vending Machine
An empty area except for an odd looking vending machine. The car wreckage is West. The car repair shop is East.

You can see the cigarette machine here.

>e
Car Repair Shop
A poor lit garage gives you the impression that buisness is slow. The walls are baren and there there is nothing much here. You wonder if this is even the right place. There is a man named Jack sitting down behind a desk.

The cigarette vending machine is West.

You can see Jack here.

* * *

>e
Cigarette Vending Machine
An empty area except for an odd looking vending machine. The car wreckage is West. The car repair shop is East.

You can see the cigarette machine here.

>buy eninge
You can't see any such thing.

>buy tire
You don't have enough money.

>buy tail light
You don't have enough money.

>buy tire
You don't have enough money.

>i
You are carrying:
  a bronze coin

>buy tail lgiht
I only understood you as far as wanting to buy the tail light.

>buy tail light
You don't have enough money.

>e
Car Repair Shop
A poor lit garage gives you the impression that buisness is slow. The walls are baren and there there is nothing much here. You wonder if this is even the right place. There is a man named Jack sitting down behind a desk.

The cigarette vending machine is West.

You can see Jack here.

>w
Cigarette Vending Machine
An empty area except for an odd looking vending machine. The car wreckage is West. The car repair shop is East.

You can see the cigarette machine here.

>w
Car Wreckage
Your car is a total wreck, you need to fix it ASAP.

Bathrooms are north. The roadside is West. The cigarette vending machine is East. The dead end is South.

>x trash
You can't see any such thing.

>w
Roadside
The roadside is deserted except for some trash on the side of the curb. There is a old street light next to you.

The car wreckage is East.

* * *

>x trash
You see a smashed soda can, a gum wrapper and a copper coin.

>take copper
Taken.

>e
Car Wreckage
Your car is a total wreck, you need to fix it ASAP.

Bathrooms are north. The roadside is West. The cigarette vending machine is East. The dead end is South.

* * *

>e
Cigarette Vending Machine
An empty area except for an odd looking vending machine. The car wreckage is West. The car repair shop is East.

You can see the cigarette machine here.

>buy tire
You don't have enough money.

>buy engine
You don't have enough money.

* * *

>e
Cigarette Vending Machine
An empty area except for an odd looking vending machine. The car wreckage is West. The car repair shop is East.

You can see the cigarette machine here.

>buy tail light
The machine rattles and drops a tail light with a large thud. You reach in and grab it.

* * *

>i
You are carrying:
  a tail light

>e
Car Repair Shop
A poor lit garage gives you the impression that buisness is slow. The walls are baren and there there is nothing much here. You wonder if this is even the right place. There is a man named Jack sitting down behind a desk.

The cigarette vending machine is West.

You can see Jack here.

>e
You can't go that way.

>w
Cigarette Vending Machine
An empty area except for an odd looking vending machine. The car wreckage is West. The car repair shop is East.

You can see the cigarette machine here.

* * *

>w
Car Wreckage
Your car is a total wreck, you need to fix it ASAP.

Bathrooms are north. The roadside is West. The cigarette vending machine is East. The dead end is South.

>w
Roadside
The roadside is deserted except for some trash on the side of the curb. There is a old street light next to you.

The car wreckage is East.

* * *

>x machine
An old vending machine filled with many car parts. There is a sign on the machine.

Engine - mysterious coin

Bumper - silver coin

Tail light - bronze coin

Tire - copper coin

>buy tire
You don't have enough money.

>give copper to machine
The machine rattles and drops a tire with a large thud. You reach in and grab it.

* * *

>i
You are carrying:
  a tail light

>w
Car Wreckage
Your car is a total wreck, you need to fix it ASAP.

Bathrooms are north. The roadside is West. The cigarette vending machine is East. The dead end is South.

* * *

>w
Roadside
The roadside is deserted except for some trash on the side of the curb. There is a old street light next to you.

The car wreckage is East.

>take copper
Taken.

* * *

>x machine
An old vending machine filled with many car parts. There is a sign on the machine.

Engine - mysterious coin

Bumper - silver coin

Tail light - bronze coin

Tire - copper coin

>buy tire
The machine rattles and drops a tire with a large thud. You reach in and grab it.

>i
You are carrying:
  a tire
  a tail light

>w
Car Wreckage
Your car is a total wreck, you need to fix it ASAP.

Bathrooms are north. The roadside is West. The cigarette vending machine is East. The dead end is South.

>n
Bathrooms
A ordinary public bathroom. There is graffiti on the walls, an overflowing rubbish can, and no toilet paper.

Car wreckage is South. The Convenience Store is North.

>x toilet
Something is clogging the toilet, you look closer and see something shiney. You reluctantly reach in and grab it.

It's a silver coin!

>i
You are carrying:
  Silver coin
  a tire
  a tail light

>s
Car Wreckage
Your car is a total wreck, you need to fix it ASAP.

Bathrooms are north. The roadside is West. The cigarette vending machine is East. The dead end is South.

>e
Cigarette Vending Machine
An empty area except for an odd looking vending machine. The car wreckage is West. The car repair shop is East.

You can see the cigarette machine here.

* * *

>x machine
An old vending machine filled with many car parts. There is a sign on the machine.

Engine - mysterious coin

Bumper - silver coin

Tail light - bronze coin

Tire - copper coin

>buy bumper
The machine rattles and drops a bumber with a large thud. You reach in and grab it.

>i
You are carrying:
  a bumper
  a tire
  a tail light

>w
Car Wreckage
Your car is a total wreck, you need to fix it ASAP.

Bathrooms are north. The roadside is West. The cigarette vending machine is East. The dead end is South.

* * *

>w
Roadside
The roadside is deserted except for some trash on the side of the curb. There is a old street light next to you.

The car wreckage is East.

>n
You can't go that way.

>e
Car Wreckage
Your car is a total wreck, you need to fix it ASAP.

Bathrooms are north. The roadside is West. The cigarette vending machine is East. The dead end is South.

* * *

>n
Convenience Store
 An air conditioned store with bright lights. There is a cashier at the front. Bathrooms are South.

You can see Cashier here.

>ask cashier about water
Sure, we got some. Since you are the 100th costumer today, I will give it to you for free! Congratulations!

>s
Bathrooms
A ordinary public bathroom. There is graffiti on the walls, an overflowing rubbish can, and no toilet paper.

Car wreckage is South. The Convenience Store is North.

* * *

>s
Car Wreckage
Your car is a total wreck, you need to fix it ASAP.

Bathrooms are north. The roadside is West. The cigarette vending machine is East. The dead end is South.

>s
Dead End
There is a hurt runner stretching on the curb. He looks like he needs help.

The car wreckage is North. The forest is South.

You can see Hurt Runner here.

>give runner water
You hand the water bottle to the hurt runner and he immidiatly drinks it.

"Thanks for the water man, my cramping is finally going away. Here is a mysterious coin, you deserve it!"

>i
You are carrying:
  a mysterious coin
  a bumper
  a tire
  a tail light

>n
Car Wreckage
Your car is a total wreck, you need to fix it ASAP.

Bathrooms are north. The roadside is West. The cigarette vending machine is East. The dead end is South.

>n
Bathrooms
A ordinary public bathroom. There is graffiti on the walls, an overflowing rubbish can, and no toilet paper.

Car wreckage is South. The Convenience Store is North.

>s
Car Wreckage
Your car is a total wreck, you need to fix it ASAP.

Bathrooms are north. The roadside is West. The cigarette vending machine is East. The dead end is South.

* * *

>x machine
An old vending machine filled with many car parts. There is a sign on the machine.

Engine - mysterious coin

Bumper - silver coin

Tail light - bronze coin

Tire - copper coin

>buy engine
The machine rattles and drops an engine with a large thud. You reach in and grab it.

>i
You are carrying:
  an engine
  a bumper
  a tire
  a tail light

>e
Car Repair Shop
A poor lit garage gives you the impression that buisness is slow. The walls are baren and there there is nothing much here. You wonder if this is even the right place. There is a man named Jack sitting down behind a desk.

The cigarette vending machine is West.

You can see Jack here.

>give jack bumper
You give the bumper to Jack and he smiles.

"Good, this will definetly work. Just need a few more part until your car looks new again!"

>give jack engine
You give the engine to Jack and his eyes light up.

"Wow, this will definetly work. Just need a few more part until your car looks new again!

>give jack tire
You give the tire to Jack and gives you a pat on the back.

"Great job, this will do. Just need a few more part until your car looks new again!"

>give jack light
You give the tail light to Jack and gives you a thumbs up.

"Excellent, this will do just fine. Just need a few more part until your car looks new again!"

    *** You hand the last part to Jack and he quickly fixes your car. Your car almost looks like new again! You thank him and get into your car. Feeling so relieved, you drive home at last. YOU WIN! ***

Would you like to RESTART, RESTORE a saved game, QUIT or UNDO the last command?

* * *

>buy tail light
The machine rattles and drops a tail light with a large thud. You reach in and grab it.

>give machine coin
The machine rattles and drops a tail light with a large thud. You reach in and grab it.

>i
You are carrying:
  a bumper

* * *

>buy tail light
The machine rattles and drops a tail light with a large thud. You reach in and grab it.

>x machine
An old vending machine filled with many car parts. There is a sign on the machine.

Engine - mysterious coin

Bumper - silver coin

Tail light - bronze coin

Tire - copper coin

* * *

>e
Cigarette Vending Machine
An empty area except for an odd looking vending machine. The car wreckage is West. The car repair shop is East.

You can see the cigarette machine here.

>x machine
An old black vending machine stands alone. Instead of cigarettes however, you can see many odd looking car parts. There is a faded sign taped to the machine.

Engine - mysterious coin

Bumper - silver coin

Tail light - bronze coin

Tire - copper coin

>i
You are carrying:
  a bronze coin

>buy tail light
You don't have enough money.

* * *

>x machine
An old black vending machine stands alone. Instead of cigarettes however, you can see many odd looking car parts. There is a faded sign taped to the machine.

Engine - mysterious coin

Bumper - silver coin

Tail light - bronze coin

Tire - copper coin

>buy tail light
You put the bronze coin in the machine. The machine rattles and drops a tail light with a large thud. You reach in and grab it.

>x tail light
You see nothing special about the tail light.

>read sign
You can't see any such thing.

>l
Cigarette Vending Machine
An empty area except for an odd looking vending machine. The car wreckage is West. The car repair shop is East.

You can see the cigarette machine here.

>x machine
An old black vending machine stands alone. Instead of cigarettes however, you can see many odd looking car parts. There is a faded sign taped to the machine.

Engine - mysterious coin

Bumper - silver coin

Tail light - bronze coin

Tire - copper coin

>read sign
You can't see any such thing.

* * *

>l
Cigarette Vending Machine
An empty area except for an odd looking vending machine. The car wreckage is West. The car repair shop is East.

You can see the cigarette machine here.

>e
Car Repair Shop
A poorly lit garage gives you the impression that business is slow. The walls are barren and there is nothing much here. You wonder if this is even the right place. There is a man named Jack sitting down behind a desk.

The cigarette vending machine is West.

You can see Jack here.

>talk to jack
That's not a verb I recognise.

>ask jack about car
Your car needs fixing? Well you have come to right place stranger. I can easily fix it for you except that I am on a shortage of parts right now. However, if you bring me the parts, I will fix your car up.

>ask jack about parts
There is no reply.

>give tail light to jack
You give the tail light to Jack and gives you a thumbs up.

"Excellent, this will do just fine. Just need a few more part until your car looks new again!"

>l
Car Repair Shop
A poorly lit garage gives you the impression that business is slow. The walls are barren and there is nothing much here. You wonder if this is even the right place. There is a man named Jack sitting down behind a desk.

The cigarette vending machine is West.

You can see Jack here.

>x desk
an old maple desk. Very sturdy and long lasting.

>open desk
It isn't something you can open.

>l
Car Repair Shop
A poorly lit garage gives you the impression that business is slow. The walls are barren and there is nothing much here. You wonder if this is even the right place. There is a man named Jack sitting down behind a desk.

The cigarette vending machine is West.

You can see Jack here.

>e
You can't go that way.

* * *

>w
Cigarette Vending Machine
An empty area except for an odd looking vending machine. The car wreckage is West. The car repair shop is East.

You can see the cigarette machine here.

>e
Car Repair Shop
A poorly lit garage gives you the impression that business is slow. The walls are barren and there is nothing much here. You wonder if this is even the right place. There is a man named Jack sitting down behind a desk.

The cigarette vending machine is West.

You can see Jack here.

>w
Cigarette Vending Machine
An empty area except for an odd looking vending machine. The car wreckage is West. The car repair shop is East.

You can see the cigarette machine here.

* * *

>n
Bathrooms
A ordinary public bathroom. There is graffiti on the walls, an overflowing rubbish can, and no toilet paper.

Car wreckage is South. The Convenience Store is North.

>x can
An overflowing trash can, nothing special.

>x graffiti
I droPPeD soMEThinG iN THE toiLeT :)

>x toilet
Something is clogging the toilet, you look closer and see something shiny. You reluctantly reach in and grab it.

It's a silver coin!

>i
You are carrying:
  Silver coin

>s
Car Wreckage
Your car is a total wreck, you need to fix it ASAP.

Bathrooms are north. The roadside is West. The cigarette vending machine is East. The dead end is South.

* * *

>s
Dead End
There is a hurt runner stretching on the curb. It looks like his leg is cramping. He may need your help.

The car wreckage is North. The forest is South.

You can see Hurt Runner here.

>help runner
That's not a verb I recognise.

>ask runner about leg
I can't move because my leg is cramping hard, do you have any water?

>no
That was a rhetorical question.

>give coin to runner
Hurt Runner doesn't seem interested.

>s
Forest
What lies beyond here is a mystery. All you see is tall trees. The dead end is North.

>n
Dead End
There is a hurt runner stretching on the curb. It looks like his leg is cramping. He may need your help.

The car wreckage is North. The forest is South.

You can see Hurt Runner here.

>n
Car Wreckage
Your car is a total wreck, you need to fix it ASAP.

Bathrooms are north. The roadside is West. The cigarette vending machine is East. The dead end is South.

* * *

>s
Dead End
There is a hurt runner stretching on the curb. It looks like his leg is cramping. He may need your help.

The car wreckage is North. The forest is South.

You can see Hurt Runner here.

>s
Forest
What lies beyond here is a mystery. All you see is tall trees. The dead end is North.

>s
You can't go that way.

>n
Dead End
There is a hurt runner stretching on the curb. It looks like his leg is cramping. He may need your help.

The car wreckage is North. The forest is South.

You can see Hurt Runner here.

* * *

>n
Car Wreckage
Your car is a total wreck, you need to fix it ASAP.

Bathrooms are north. The roadside is West. The cigarette vending machine is East. The dead end is South.

>w
Roadside
The roadside is deserted except for some trash on the side of the curb. There is a old street light next to you.

The car wreckage is East.

* * *

>x trash
You see a smashed soda can, a gum wrapper and a copper coin.

>take coin
(Silver coin)
You already have that.

>take copper coin
Taken.

>take wrapper
Taken.

>take soda can
Taken.

>l
Roadside
The roadside is deserted except for some trash on the side of the curb. There is a old street light next to you.

The car wreckage is East.

>x street light
rusty and silver. There is nothing special about it.

>s
You can't go that way.

>n
You can't go that way.

* * *

>e
Car Wreckage
Your car is a total wreck, you need to fix it ASAP.

Bathrooms are north. The roadside is West. The cigarette vending machine is East. The dead end is South.

>s
Dead End
There is a hurt runner stretching on the curb. It looks like his leg is cramping. He may need your help.

The car wreckage is North. The forest is South.

You can see Hurt Runner here.

>i
You are carrying:
  smashed soda can
  Gum wrapper
  Copper coin
  Silver coin

>give can to runner
Hurt Runner doesn't seem interested.

>give wrapper to runner
Hurt Runner doesn't seem interested.

>s
Forest
What lies beyond here is a mystery. All you see is tall trees. The dead end is North.

* * *

>w
Car Wreckage
Your car is a total wreck, you need to fix it ASAP.

Bathrooms are north. The roadside is West. The cigarette vending machine is East. The dead end is South.

>e
Cigarette Vending Machine
An empty area except for an odd looking vending machine. The car wreckage is West. The car repair shop is East.

You can see the cigarette machine here.

* * *

>x machine
An old black vending machine stands alone. Instead of cigarettes however, you can see many odd looking car parts. There is a faded sign taped to the machine.

Engine - mysterious coin

Bumper - silver coin

Tail light - bronze coin

Tire - copper coin

>buy bumper
You put the silver coin in the machine. The machine rattles and drops a bumper with a large thud. You reach in and grab it.

>buy tire
You put the copper coin in the machine. The machine rattles and drops a tire with a large thud. You reach in and grab it.

>i
You are carrying:
  a tire
  a bumper
  smashed soda can
  Gum wrapper

>s
You can't go that way.

* * *

>n
You can't go that way.

>w
Car Wreckage
Your car is a total wreck, you need to fix it ASAP.

Bathrooms are north. The roadside is West. The cigarette vending machine is East. The dead end is South.

* * *

>e
Car Repair Shop
A poorly lit garage gives you the impression that business is slow. The walls are barren and there is nothing much here. You wonder if this is even the right place. There is a man named Jack sitting down behind a desk.

The cigarette vending machine is West.

You can see Jack here.

>give bumper to Jack
You give the bumper to Jack and he smiles.

"Good, this will definitely work. Just need a few more part until your car looks new again!"

>i
You are carrying:
  a tire
  smashed soda can
  Gum wrapper

>give tire to jack
You give the tire to Jack and gives you a pat on the back.

"Great job, this will do. Just need a few more part until your car looks new again!"

>i
You are carrying:
  smashed soda can
  Gum wrapper

>l
Car Repair Shop
A poorly lit garage gives you the impression that business is slow. The walls are barren and there is nothing much here. You wonder if this is even the right place. There is a man named Jack sitting down behind a desk.

The cigarette vending machine is West.

You can see Jack here.

>w
Cigarette Vending Machine
An empty area except for an odd looking vending machine. The car wreckage is West. The car repair shop is East.

You can see the cigarette machine here.

* * *

>w
Car Wreckage
Your car is a total wreck, you need to fix it ASAP.

Bathrooms are north. The roadside is West. The cigarette vending machine is East. The dead end is South.

>s
Dead End
There is a hurt runner stretching on the curb. It looks like his leg is cramping. He may need your help.

The car wreckage is North. The forest is South.

You can see Hurt Runner here.

* * *

>n
Convenience Store
 An air conditioned store with bright lights. There is a cashier at the front. Bathrooms are South.

You can see Cashier here.

>ask cashier about store
There is no reply.

>ask cashier about water
Sure, we got some. Since you are the 100th costumer today, I will give it to you for free! Congratulations!

* * *

>s
Dead End
There is a hurt runner stretching on the curb. It looks like his leg is cramping. He may need your help.

The car wreckage is North. The forest is South.

You can see Hurt Runner here.

>give water to runner
You hand the water bottle to the hurt runner and he immediately drinks it.

"Thanks for the water man, my cramping is finally going away. Here is a mysterious coin, you deserve it!"

>e
You can't go that way.

>w
You can't go that way.

>n
Car Wreckage
Your car is a total wreck, you need to fix it ASAP.

Bathrooms are north. The roadside is West. The cigarette vending machine is East. The dead end is South.

* * *

>e
Cigarette Vending Machine
An empty area except for an odd looking vending machine. The car wreckage is West. The car repair shop is East.

You can see the cigarette machine here.

>x machie
You can't see any such thing.

>x machine
An old black vending machine stands alone. Instead of cigarettes however, you can see many odd looking car parts. There is a faded sign taped to the machine.

Engine - mysterious coin

Bumper - silver coin

Tail light - bronze coin

Tire - copper coin

>buy engine
You put the mysterious coin in the machine. The machine rattles and drops an engine with a large thud. You reach in and grab it.

>w
Car Wreckage
Your car is a total wreck, you need to fix it ASAP.

Bathrooms are north. The roadside is West. The cigarette vending machine is East. The dead end is South.

* * *

>e
Car Repair Shop
A poorly lit garage gives you the impression that business is slow. The walls are barren and there is nothing much here. You wonder if this is even the right place. There is a man named Jack sitting down behind a desk.

The cigarette vending machine is West.

You can see Jack here.

>give engine to jack
You give the engine to Jack and his eyes light up.

"Wow, this will definitely work. Just need a few more part until your car looks new again!

    *** You hand the last part to Jack and he quickly fixes your car. Your car almost looks like new again! You thank him and get into your car. Feeling so relieved, you drive home at last. YOU WIN! ***

Would you like to RESTART, RESTORE a saved game, QUIT or UNDO the last command?

* * *

>x machine
An old black vending machine stands alone. Instead of cigarettes however, you can see many odd looking car parts. There is a faded sign taped to the machine.

Engine - mysterious coin

Bumper - silver coin

Tail light - bronze coin

Tire - copper coin

>buy light
The machine rattles and drops a tail light with a large thud. You reach in and grab it.

>i
You are carrying:
  a tail light
  a bumper

* * *

>e
Car Repair Shop
A poorly lit garage gives you the impression that business is slow. The walls are barren and there is nothing much here. You wonder if this is even the right place. There is a man named Jack sitting down behind a desk.

The cigarette vending machine is West.

You can see Jack here.

>give coin to jack
Not me, the vending machine man! Do I look like a vending machine to you?

>i
You are carrying:
  Bronze coin

>give jack coin
Not me, the vending machine man! Do I look like a vending machine to you?

* * *

>e
Car Repair Shop
A poorly lit garage gives you the impression that business is slow. The walls are barren and there is nothing much here. You wonder if this is even the right place. There is a man named Jack sitting down behind a desk.

The cigarette vending machine is West.

You can see Jack here.

>hit jack
Violence isn't the answer to this one.

* * *

>n
Bathrooms
A ordinary public bathroom. There is graffiti on the walls, an overflowing rubbish can, and no toilet paper.

Car wreckage is South. The Convenience Store is North.

* * *

>s
Bathrooms
A ordinary public bathroom. There is graffiti on the walls, an overflowing rubbish can, and no toilet paper.

Car wreckage is South. The Convenience Store is North.

>x toilet
Something is clogging the toilet, you look closer and see something shiney. You reluctantly reach in and grab it.

It's a silver coin!

>s
Car Wreckage
Your car is a total wreck, you need to fix it ASAP.

Bathrooms are north. The roadside is West. The cigarette vending machine is East. The dead end is South.

* * *

>e
Car Wreckage
Your car is a total wreck, you need to fix it ASAP.

Bathrooms are north. The roadside is West. The cigarette vending machine is East. The dead end is South.

>s
Dead End
There is a hurt runner stretching on the curb. He looks like he needs help.

The car wreckage is North. The forest is South.

You can see Hurt Runner here.

* * *

>give runner water
You hand the water bottle to the hurt runner and he immidiatly drinks it.

"Thanks for the water man, my cramping is finally going away. Here is a mysterious coin, you deserve it!"

>n
Car Wreckage
Your car is a total wreck, you need to fix it ASAP.

Bathrooms are north. The roadside is West. The cigarette vending machine is East. The dead end is South.

* * *

>e
Cigarette Vending Machine
An empty area except for an odd looking vending machine. The car wreckage is West. The car repair shop is East.

You can see the cigarette machine here.

>i
You are carrying:
  a mysterious coin
  Copper coin
  silver coin
  a bronze coin

>give mysterious coin to machine
The machine rattles and drops an engine with a large thud. You reach in and grab it.

>i
You are carrying:
  an engine
  silver coin
  a bronze coin

I beg your pardon?

>give silver coin to machine
The machine rattles and drops a bumber with a large thud. You reach in and grab it.

>give bronze coin to machine
The machine rattles and drops a tail light with a large thud. You reach in and grab it.

>i
You are carrying:
  a tail light
  a bumper
  an engine

>x machine
An old vending machine filled with many car parts. There is a sign on the machine.

Engine - mysterious coin

Bumper - silver coin

Tail light - bronze coin

Tire - copper coin

* * *

>buy tire
You don't have enough money.

>give copper coin to machine
You can't see any such thing.

I beg your pardon?

* * *

>s
Dead End
There is a hurt runner stretching on the curb. It looks like his leg is cramping. He may need your help.

The car wreckage is North. The forest is South.

You can see Hurt Runner here.

>hit runner
You smack him right in the face and he starts to cry. He calls 911 and you go to jail. Violence is not the answer.

    *** You loose. ***

Would you like to RESTART, RESTORE a saved game, QUIT or UNDO the last command?